1111111
1P000E1
1000001
1C000E1
1111111