1111111
1P00001
1000011
1C001E1
1111111