111111
1P00C1
1E0001
1C00C1
111111