111111
1P00C1
1000001
1C00E1
111111