111111
1P00C1
100000
1C00E1
111111